11111111111111111111111111111111111111111111111111
10000000000000000000011211101110000001000100000001
11111111011111101110000000000000110101010101101101
11000011110000010001111111111111110100010001101101
10000101111111000100000000000000000110111110000001
11010100000100011011110111101110111010110110111101
10000110110101000001011110000000000000000000111001
11101110010001101100000011110001101101100110010011
11000000001110001111131110000001110001110000000111
11111111111111111111111111111111111111111111111111

