111111111111111111111111111111
111100000000000000000000000001
111101101101101101110110110101
111101101101101101110110110101
120000000000000000000000000001
111101101101101101110110110101
111101101101101101130110110101
111101101101101101110110110101
111100000000000000000000000001
111111111111111111111111111111
