111111111111
121100001111
101101101111
101101101111
100000000111
110111010011
110010011311
111111111111
