111111111111111111111111111111
111111100000000000000111111111
111111001111111111100000000011
111110011111111111101001111011
111100110000000000001100111011
111101110111111101111110111011
111100000000000000000000000011
111101110111011110111110111011
111101110111011110111110111011
111100110110000000011100111011
111110010111111011111001300011
111111000111111111110011111011
111111100000000000000111000011
111111111111121111111100011111
111111111111111111111111111111
