111111111111111111111111111111111111
121111000100000000000111111111111111
101111110101111111110111111111111111
100000000100000000010100111111111111
111111110111101111010110111110001111
111111110000001110010000111100100111
111111111011111110110111111001110011
111111111011000000110111110011111011
111111110000010111110111110111111011
111111111111110111110111100111110011
111111000000000111110000001111100111
111111011111111111111111111111001111
111111011111111111111111111111011111
111000000000000000000000000000011111
111011111110111111011111111111111111
111000000000000000000000000000011111
111011111111101111101111111111011111
111000000000000110000000000000010001
111111110111111111110111111111110101
111000000000000000000111000011000101
111110111111110111111111011011011101
111000111111110000000000011000011001
111111111111111111111111111111111031
111111111111111111111111111111111111
