111111111111
100011110001
111000010101
111011010101
111013010101
111011110101
111000000121
111111111111


