11111111111111111111111111
10000000000000000000000001
10110110111111011111111101
10110110111111000000000001
10000000000000011111111101
10110110111111011111111101
10110110111120000000000001
10110110111111111101111101
10000000000011111101111101
10110110111000311100000001
10110110111111111101111101
10000000000000000000000001
11111111111111111111111111
