111111111111111111111
100000101000000000001
111110101011111111101
100010100010000000101
101010101010111011101
121010101000100010001
111010111111111010111
100010000000001010001
101111111111101011101
101000100000001010001
101010101111101110111
100010000010000000101
111111111010111011101
100010001010001010001
111011101011101010111
100010001010001000001
101110101110111011111
101000100000001010001
101110111111101010101
100000100000001000131
111111111111111111111
